wwwwwwwwwwwwwwwwwwwwww
wA........w..........w
w....a.w..x..........w
w................w...w
w....w.....w.........w
w...w..........e.....w
w...x....e.......w...w
w..........a.........w
w....................w
wwwwwwwwwwwwwwwwwwwwww
