wwwwwwwwwwwwwwwwwwwwww
w.........w..........w
w.w..a....x..........w
w....................w
w.....w....w.........w
w..............y.....w
w...x....y...........w
w.....w....a....w....w
w..........A.........w
wwwwwwwwwwwwwwwwwwwwww
