wwwwwwwwwwwwwwwwwwwwwwww
wwwwwwwdwwwdwwwdwwwwwwww
wwwwwww.www.www.wwwwwwww
wwwwwww.www.www.wwwwwwww
wd..www.www.www.www...dw
ww..www.www.www.www.wwww
w....n..n.......n...n..w
w......................w
w......................w
w......................w
w...........A..........w
w......................w
w......................w
w......................w
w......................w
w..m...m...m...m...m...w
wwww..ww.wwwwwww.www..ww
wv....ww.wwwwwww.www..vw
wwwwwwww.wwwwwww.wwwwwww
wwwwwwwwvwwwwwwwvwwwwwww
wwwwwwwwwwwwwwwwwwwwwwww