wwwwwwwwwwwwwwwwwwwwwwwwww
wA.......................w
w........................w
w............a...........w
w.....a..................w
w....................a...w
w..........a.............w
w........................w
w........................w
wwwwwwwwwwwwwwwwwwwwwwwwww
