wwwwwwwwwwwwwwwwwwwwwwwwww
wA.......................w
w................c.......w
w......e.....a...........w
wwww.....................w
w.aw.................a...w
wwww.......a.............w
w..............c.........w
w....................e...w
wwwwwwwwwwwwwwwwwwwwwwwwww